{
  "LevelName":"lvl1",
  "Timeout":132,
  "Weapron":{
    "automata":25,
    "shotgun":1
  },
  "MapLayout":[
    [0,0,0,0, 0, 0, 0, 0, 0, 1, 0, 0, 0, 0, 2, 0, 0],
    [0,0,0,0, 0, 0, 0, 0, 2, 0, 0, 0, 0, 0, 0, 0, 0],
    [0,1,0,0, 0, 1, 0, 0, 0, 0, 0, 0, 0, 1, 0, 0, 0],
    [0,0,2,0, 0, 0, 0, 0, 2, 1, 2, 0, 0, 0, 0, 0, 0],
    [0,0,0,0, 0, 0, 1, 0, 2, 0, 0, 0, 0, 0, 0, 2, 0]
    ]
}