{
  "LevelName":"lvl2",
  "Timeout":132,
  "Weapron":{
    "automata":20,
    "shotgun":3
  },
  "MapLayout":[
    [0,1,0,0, 0, 0, 0, 0, 0, 1, 0, 0, 0, 0, 2, 0, 0],
    [0,0,0,0, 0, 0, 2, 0, 2, 0, 0, 2, 0, 0, 1, 2, 0],
    [0,1,0,0, 0, 1, 0, 0, 0, 1, 0, 1, 0, 1, 0, 0, 0],
    [0,1,1,1, 0, 0, 1, 0, 2, 1, 2, 0, 0, 1, 0, 2, 0],
    [0,0,0,0, 0, 0, 1, 0, 2, 0, 0, 0, 0, 0, 0, 2, 0]
    ]
}