{
  "LevelName":"lvl3",
  "Timeout":132,
  "Weapron":{
    "automata":120,
    "shotgun":3
  },
  "MapLayout":[
    [0,1,0,0, 1, 0, 0, 2, 0, 1, 0, 0, 0, 3, 2, 0, 0],
    [0,0,0,0, 0, 0, 2, 0, 2, 0, 0, 2, 0, 0, 1, 2, 0],
    [0,0,0,0, 0, 1, 0, 0, 0, 1, 0, 1, 3, 3, 0, 1, 0],
    [1,3,1,3,1, 0, 0, 3, 1, 2, 1, 2, 0, 0, 1, 0, 2],
    [3,0,0,0, 0, 0, 1, 0, 2, 0, 0, 3, 0, 0, 0, 0, 0],
    [3,0,0,1, 0, 0, 1, 0, 2, 0, 0, 3, 0, 3, 0, 2, 0]
    ]
}